%%%%%%%%
%.    .%
%   P  %
% %%%% %
% %    %
% % %%%%
% %   .%
%%%%%%%%
